RowData
XXXXXXXXXXXXXXXXXXXX
XXXXXXXXXXXXXXXXXXXX
XXXXXXXXXXXXXXXXXXXX
XXXXXXXXXXXXXXXXXXXX
XXXXXXXXXXXXXXXXXXXX
XXXXXX________XXXXXX
XXXXXX________XXXXXX
XXXXXX________XXXXXX
XXXXXX________XXXXXX
XXXXXX________XXXXXX
XXXXXX________XXXXXX
XXXXXX________XXXXXX
XXXXXXXX____XXXXXXXX
XXXXXXXX____XXXXXXXX
XXXXXXXX____XXXXXXXX
XXXXXXXX____XXXXXXXX
XXXXXXXX____XXXXXXXX
XXXXXXXX____XXXXXXXX
XXXXXXXX____XXXXXXXX
XXXXXXXX____XXXXXXXX
XXXXXXXX____XXXXXXXX
XXXXXXXX____XXXXXXXX
XXXXXXXX____XXXXXXXX
XXXXXXXX____XXXXXXXX
XXXXXXXX____XXXXXXXX
XXXXXXXX____XXXXXXXX
XXXXXXXX____XXXXXXXX
XXXXXXXX____XXXXXXXX
XXXXXXXX____XXXXXXXX
X__________________X
X__________________X
X__________________X
X__________________X
X__________________X
X__________________X
X__________________X
X__________________X
X__________________X
X__________________X
X__________________X
X__________________X
XXXXXXXXXXXXXXXXXXXX
