RowData
XXXXXXXXXXX________XXXXXXXXXXXX
XXXXXXXXXXX________XXXXXXXXXXXX
XXXXXXXXXXX________XXXXXXXXXXXX
XXXXXXXXXXX________XXXXXXXXXXXX
XXXXXXXXXXX________XXXXXXXXXXXX
XXXXXXXXXXX_________XXXXXXXXXXX
XXXXXXXXX____________XX__XXXXXX
XXXXXXX__________________XXXXXX
XXXXXX____________________XXXXX
XXXX_____________________XXXXXX
________________________XXXXXXX
________________________XXXXXXX
__________________________XXXXX
_______________________________
___________________________XXXX
__________________________XXXXX
____________________XXX___XXXXX
___________________XXXX__XXXXXX
___________________XXXXXXXXXXXX
XXXXX___________XXXXXXXXXXXXXXX
XXXXXXX_______XXXXXXXXXXXXXXXXX
XXXXXXXX_____XXXXXXXXXXXXXXXXXX
XXXXXXXX___XXXXXXXXXXXXXXXXXXXX
XXXXXXXX___XXXXXXXXXXXXXXXXXXXX
XXXXXXXX___XXXXXXXXXXXXXXXXXXXX
XXXXXXXX___XXXXXXXXXXXXXXXXXXXX
XXXXXXXX___XXXXXXXXXXXXXXXXXXXX
