RowData
XXXXXXXXXX________XXXXXXXXXXX
XXXXXXXXXX________XXXXXXXXXXX
XXXXXXXXXX________XXXXXXXXXXX
XXXXXXXXXX________XXXXXXXXXXX
XXXXXXXXXX________XXXXXXXXXXX
XXXXXXXXXX_________XXXXXXXXXX
XXXXXXXX____________XX__XXXXX
XXXXXX__________________XXXXX
XXXXX____________________XXXX
XXX_____________________XXXXX
_______________________XXXXXX
_______________________XXXXXX
_________________________XXXX
_____________________________
__________________________XXX
_________________________XXXX
___________________XXX___XXXX
__________________XXXX__XXXXX
__________________XXXXXXXXXXX
XXXX___________XXXXXXXXXXXXXX
XXXXXX_______XXXXXXXXXXXXXXXX
XXXXXXX_____XXXXXXXXXXXXXXXXX
XXXXXXX___XXXXXXXXXXXXXXXXXXX
XXXXXXX___XXXXXXXXXXXXXXXXXXX
XXXXXXX___XXXXXXXXXXXXXXXXXXX
XXXXXXX___XXXXXXXXXXXXXXXXXXX
XXXXXXX___XXXXXXXXXXXXXXXXXXX
