RowData
XXXXXXXXXXXXXXXXXXXXXXXX
X______________________X
X______________________X
X______________________X
X______________________X
X______________________X
X______________________X
X______________________X
X______________________X
X______________________X
X________XX___X________X
X________X_____________X
X_____________X________X
X________X___XX________X
X______________________X
X______________________X
X______________________X
X______________________X
X______________________X
X______________________X
X______________________X
X______________________X
X______________________X
XXXXXXXXXXXXXXXXXXXXXXXX
