RowData
XXXXXXXXXXXXXXXXXXXXXXXX
X______________________X
X______________________X
X______________________X
X______________________X
X______________________X
X______________________X
X______________________X
X______________________X
X______________________X
X_________XX_X_________X
X_________X____________X
X____________X_________X
X_________X_XX_________X
X______________________X
X______________________X
X______________________X
X______________________X
X______________________X
X______________________X
X______________________X
X______________________X
X______________________X
XXXXXXXXXXXXXXXXXXXXXXXX
